########################################################
#...............#.......#..............................#
#.......................#.%............................#
#...............#.......#..............................#
#...............#.......#..............................#
#################.......#..............................#
#.......................#..............................#
#.......................#..............................#
#.......................#..............................#
#.........#####################################........#
#.........#............................................#
#.........#............................................#
#......................................................#
#.........#............................................#
########################################################