########################################################
#              #..............#                #########
#              #..............#                #.......#
#              #..............#                #.#####.#
#              #..............#                #.# #...#
#              #..............#                #.# #...#
#              ######....######                #.# #...#
#                   #....#                     #.# #...#
###########   #######....#######   ##########  #.# #...#
#.........#   #................#   #........#  #.# #...#
#.........#####................#####........####.# #.%.#
#................................................# #####
#.........#####................#####........######     #
#.........#   #................#   #........#          #
########################################################