########################################################
#                  #..............#            #########
#                  #..............#            #.......#
#                  #..............#            #.#####.#
#                  #..............#            #.# #...#
#                  #..............#            #.# #...#
#                  ######....######            #.# #...#
#                       #....#                 #.# #...#
###########   #######....#######   ##########  #.# #...#
#.........#   #................#   #........#  #.# #...#
#.........#####................#####........####.# #.%.#
#.................................................# ####
#.........#####................#####........######     #
#.........#    #................#  #........#          #
########################################################