########################################################
#%..............#............#.........................#
#............................#............%............#
#...............#............#.........................#
#...............#............#.........................#
#################............#.........................#
#............................#.........................#
#............................#.........................#
#............................#.........................#
#.........#####################################........#
#.........#............................................#
#.........#............................................#
#......................................................#
#.........#............................................#
########################################################